0 0 0 0 0 0 0 0 0 0 0 0 0 0 0 0
0 1 3 0 1 3 0 1 3 0 1 3 0 1 3 0
0 7 5 0 5 7 0 5 7 0 5 7 0 5 7 0
0 0 0 0 0 0 0 0 0 0 0 0 0 0 0 0
0 1 3 0 1 3 0 1 3 0 1 3 0 1 3 0
0 7 5 0 5 7 0 5 7 0 5 7 0 5 7 0
0 0 0 0 0 0 0 0 0 0 0 0 0 0 0 0
0 1 3 0 1 3 0 1 3 0 1 3 0 1 3 0
0 7 5 0 5 7 0 5 7 0 5 7 0 5 7 0
0 0 0 0 0 0 0 0 0 0 0 0 0 0 0 0
0 1 3 0 1 3 0 1 3 0 1 3 0 1 3 0
0 7 5 0 5 7 0 5 7 0 5 7 0 5 7 0
0 0 0 0 0 0 0 0 0 0 0 0 0 0 0 0
0 1 3 0 1 3 0 1 3 0 1 3 0 1 3 0
0 7 5 0 5 7 0 5 7 0 5 7 0 5 7 0
0 0 0 0 0 0 0 0 0 0 0 0 0 0 0 0